1111111
10CE0P1
1111111
1111111